also remove image=také odstranit obraz
Apply=Použít
Are you sure=Jste si jistí?
Cancel=Zrušit
checking=kontroluji
Completely REMOVE=Kompletně ODSTRANIT
Console=Konzole
day=den
days=dní
disk image and definition=obraz a definice disku
Disks=Disky
Donate=Přispět
Done=Hotovo
Edit=Upravit
Execution error=Chyba provádění
Force Stop=Vynutit zastavení
Hibernate=Hibernovat
Log for=Záznam pro:
log=záznam
Logs=Záznamy
More Info=Více informací
No=Ne
OK=OK
Ok=OK
Pause=Pozastavit
Proceed=Pokračovat
Project Page=Stránka projektu
Read Me First=Nejdříve si přečtěte
Remove container=Odstranit kontejner
Remove definition=Odstranit definici
Remove image=Odstranit obraz
Remove VM=Odstranit virtuální stroj
Remove=Odstranit
Restart=Restartovat
Resume=Obnovit
Start=Spustit
Stop=Zastavit
Support=Podpora
Update container=Aktualizovat kontejner
Update=Aktualizovat
Updating all Containers=Aktualizuji všechny kontejnery
Updating the container=Aktualizuji kontejner
VNC Remote=Vzdálené ovládání VNC
WebUI=Webové rozhraní
Yes, delete it=Ano, smazat!
Yes, update it=Ano, aktualizovat!
Yes=Ano

; footer messages
Array Copying=Pole se kopíruje
Array Clearing=Pole se čistí
Array Starting=Pole se spouští
Array Stopping=Pole se zastavuje
Mounting disks=Připojuji disky
Retry unmounting user shares=Zkouším znovu odpojit uživatelská sdílení
Spinning up all drives=Zapínám disky
Stale configuration=Zastaralé nastavení
Starting services=Spouštím služby
Stopping services=Zastavuji služby
Starting Recycle Bin=Spouštím Koš
Stopping Recycle Bin=Vypínám koš
Sync filesystems=Synchronizovat systémy souborů
Unmounting disks=Odpojuji disky
Autostart disabled=Automatické spuštění vypnuté
Missing encryption key=Chybí šifrovací klíč
Opening encrypted volumes=Otevírán šifrované oddíly

; docker variables
Container Path=Cesta kontejneru
Container Port=Port kontejneru
Container Variable=Proměnná kontejneru
Container Label=Název kontejneru
Container Device=Zařízení kontejneru
