A format is NEVER part of a data recovery or disk rebuild process and if done in such circumstances will normally lead to loss of all data on the disks being formatted=Formátování **NIKDY** není součástí procesu obnovy dat nebo obnovy disku. Pokud je provedeno za těchto okolností, obvykle to povede ke ztrátě všech dat na formátovaném disku.
Aborted=Přerušeno
Action=Akce
Add Pool=Přidat pool
Add Subpool=Přidat subpool
Add ZFS Subpool=Přidat ZFS subpool
Add=Přidat
After renaming the pool, check that your shares are assigned to the proper primary and secondary storage locations=Po přejmenování poolu zkontroluj, zda jsou tvá sdílení přiřazena ke správným primárním a sekundárním úložným umístěním.
After upgrading the volume may not be mountable in previous versions of Unraid=Po upgradu může být svazek v předchozích verzích Unraidu nepřipojitelný.
All existing data on this device will be OVERWRITTEN when array is Started=Veškerá data na tomto zařízení budou PŘEPSÁNA při spuštění array.
Array Devices=Disky pole (Array)
Array of %s devices=Pole o %s discích
Array Operation=Operace nad polem
Attribute Name=Název atributu
Attributes not available=Atributy nejsou dostupné
Attributes=Atributy
auto=auto
Autotrim=Automatické ořezávání
Balance Status=Stav vyvážení
Balance=Vyvážení
Blacklisted=Na černé listině
Boot Device=Zaváděcí zařízení
Boot system in UEFI mode=Spustit systém v režimu UEFI
btrfs balance status=Stav vyvážení btrfs
btrfs check status=Stav kontroly btrfs
btrfs filesystem usage=Využití souborového systému BTRFS
BTRFS operation is running=Probíhá operace BTRFS
btrfs scrub status=Stav čištění btrfs
cache - Cache Devices=cache – cache disky
cache - L2ARC=cache – L2ARC
Canceled=Zrušeno
Cannot contact key-server Please check your=Nelze se spojit s klíčovým serverem. Zkontrolujte své
Capabilities not available=Funkce nejsou dostupné
Capabilities=Funkce
Caution=**Pozor**
Check Filesystem Status=Zkontrolovat stav souborového systému
Clear Stats=Vymazat statistiky
Clearing in progress=Probíhá mazání
Click on FLASH above this message=Klikněte na **FLASH** výše nad touto zprávou
Click to spin down device=Klikněte pro zastavení disku
Click to spin up device=Klikněte pro spuštění disku
Comments=Komentáře
complete=kompletní
Completed without error=Dokončeno bez chyby
completed=dokončeno
Compression=Komprese
Configuration valid=Konfigurace je platná
Convert to raid0 mode=Převést na režim raid0
Convert to raid1 mode=Převést na režim raid1
Convert to raid10 mode=Převést na režim raid10
Convert to raid1c3 mode=Převést na režim raid1c3
Convert to raid1c4 mode=Převést na režim raid1c4
Convert to raid5 mode see help=Převést na režim raid5 – viz nápověda
Convert to raid6 mode see help=Převést na režim raid6 – viz nápověda
Convert to single mode=Převést na režim single
Copying=Kopírování
corrected=Opraveno
Create an empty file system on the disks shown as Unmountable discarding all data currently on the disks and update parity to reflect this=Vytvořit prázdný souborový systém na discích označených jako nepřipojitelné, smazat všechna aktuální data na těchto discích a aktualizovat paritu.
creating Flash backup zip file this may take several minutes=Vytváření ZIP souboru se zálohou Flash disku – může to trvat několik minut
Creating Flash backup=Vytváření zálohy Flash disku
Creation error=Chyba při vytváření
Critical disk temperature threshold=Kritická teplotní hranice disku
Critical disk utilization threshold=Kritická hranice využití disku
Critical NVME temperature threshold=Kritická teplotní hranice NVMe
Critical SSD temperature threshold=Kritická teplotní hranice SSD
Current operation %s on %s=Probíhá operace **%s** na **%s**
Current position=Aktuální pozice
Custom attributes use comma to separate numbers=Vlastní atributy – čísla oddělujte čárkou
Data-Rebuild in progress=Probíhá obnova dat
Date of purchase=Datum pořízení
Date=Datum
dedup - Deduplication Tables=dedup – Tabulky deduplikace
Delete Pool=Smazat pool
detected=Zjištěno
Device contents invalid, in standby mode spun-down=Obsah zařízení je neplatný, disk je v režimu spánku
Device contents invalid=Obsah zařízení je neplatný
Device encrypted and unlocked=Zařízení je zašifrováno a odemčeno
Device encrypted=Zařízení je zašifrováno
Device is disabled=Zařízení je deaktivováno
Device is missing disabled=Zařízení chybí (deaktivováno)
Device is part of a pool=Zařízení je součástí poolu
Device locked unknown error=Zařízení je uzamčeno: Neznámá chyba
Device locked wrong encryption key=Zařízení je uzamčeno: Nesprávný šifrovací klíč
Device to be encrypted=Zařízení k zašifrování
Dirty log detected=Zjištěn poškozený log
Disable Spin down delay to run a SMART extended self-test=Deaktivuj zpoždění vypnutí disku pro spuštění rozšířeného SMART testu
Disk in parity slot is not biggest=Paritní disk není největší
Disk Log Information=Informace z protokolu disku
Disk-Clear in progress=Probíhá vymazání disku
Do not use reserved names=Nepoužívej rezervovaná jména
Do not use user share names=Nepoužívej názvy uživatelských sdílení
Download SMART report=Stáhnout SMART zprávu
Dual parity valid requires ALL disks in their original slots=Dvojitá parita je platná pouze, pokud jsou **všechny** disky na svých původních pozicích
Elapsed time=Uplynulý čas
Enable user share assignment=Povolit přiřazení uživatelských sdílení
encrypted=zašifrováno
Encryption input=Vstup pro šifrování
Encryption status=Stav šifrování
enter disk index and device name as applicable to your controller=Zadej index disku a název zařízení podle svého řadiče
Enter new key=Zadej nový klíč
Erase Device Content=Smazat obsah zařízení
Errors occurred - Check SMART report=Došlo k chybám – zkontroluj SMART zprávu
Estimated finish=Odhadované dokončení
Estimated speed=Odhadovaná rychlost
Existing content is permanently lost=Stávající obsah bude trvale ztracen
Failed=Selhalo
Feature=Funkce
File system corruption detected=Zjištěno poškození souborového systému
File system status=Stav souborového systému
File system type=Typ souborového systému
Finding %s error=**%s** chyba nalezena
Finding %s errors=**%s** chyb nalezeno
Fix=Opravit
Flag=Označit
Flash backup=Záloha Flash disku
Flash device is set as public share=Flash disk je nastaven jako veřejné sdílení
Flash Device Settings=Nastavení Flash zařízení
Format Unmountable disks=Formátovat nepřipojitelné disky
Formatting=Formátování
formatting=formátování
Free=Volné
FS=FS
Global Configuration=Globální nastavení
Hide=Skrýt
Identification=Identifikace
Identity is not available=Identita není dostupná
Identity=Identita
if checked, Start array but do not mount disks=Pokud je zaškrtnuto, spustit pole bez připojení disků
If this is a new array, move the largest disk into the parity slot=Pokud jde o nové pole, přesuň největší disk do pozice paritního
If you are adding a new disk or replacing a disabled disk, try Parity-Swap=Pokud přidáváš nový disk nebo nahrazuješ vadný, zvaž použití Parity-Swap
Incorrect confirmation=Chybná potvrzení
Ineligible to run this version of Unraid OS Please consider extending your=Nelze spustit tuto verzi Unraid OS – zvaž prodloužení své licence
Information=Informace
Insufficient free disk space available=Nedostatek volného místa na disku
Interrupted=Přerušeno
Invalid configuration=Neplatná konfigurace
invalid device=Neplatné zařízení
invalid devices=Neplatná zařízení
Invalid expansion=Neplatné rozšíření
Invalid pool name=Neplatný název poolu
Invalid, missing or expired=Neplatné, chybějící nebo vypršelo
is only available when array is Started in Maintenance mode=Dostupné pouze při spuštění pole v režimu údržby
is only available when array is Started=Dostupné pouze při spuštění pole
Keyfile=Soubor s licencí
Last check completed on %s=Poslední kontrola dokončena **%s**
Last check incomplete on %s=Poslední kontrola nedokončena **%s**
Last checked on %s=Poslední kontrola proběhla **%s**
Last SMART test result=Výsledek posledního SMART testu
logs - Separate Intent Log SLOG=logy – samostatný záměrný log (SLOG)
logs - ZFS Intent Log=logy – ZFS záměrný log
Maintenance mode=Režim údržby
Maintenance Mode=Režim údržby
Maintenance=Údržba
Manufacturing date=Datum výroby
Menu View=Zobrazení nabídky
Minimum free space=Minimální volné místo
mirror=zrcadlo
Missing Cache disk=Chybí cache disk
Missing disk=Chybí disk
Missing key=Chybějící klíč
Missing pool disk=Chybí disk v poolu
Missing=Chybí
Mounted=Připojeno
Mover is running=Mover běží
network settings=Nastavení sítě
New data disks detected=Zjištěny nové datové disky
next device=další zařízení
No array data disks have been assigned=Nebyly přiřazeny žádné datové disky pole
No array devices have been assigned=Nebyly přiřazeny žádné disky pole
No data disks=Žádné datové disky
no devices=Žádná zařízení
No devices=Žádné zařízení
No file system corruption detected=Poškození souborového systému nebylo zjištěno
No parity check history present=Není k dispozici historie paritních kontrol
No self-tests logged on this disk=Na tomto disku nejsou záznamy o samostatných testech
Not installed=Nenainstalováno
Not present=Nepřítomný
OK=OK
Once copy completes, the array may be Started, to initiate Data-Rebuild of the disabled disk=Po dokončení kopírování lze pole spustit pro zahájení obnovy dat deaktivovaného disku
operation=Operace
Options see Help=Možnosti – viz Nápověda
Otherwise use the keyfile method for UTF8 input=V opačném případě použij metodu **keyfile** pro zadání v UTF8
Parity disks content will be overwritten=Obsah *paritních* disků bude přepsán
Parity is already valid=Parita je již platná
Parity Operation History=Historie paritních operací
Parity operation is running=Probíhá paritní operace
Parity valid requires ALL disks to have their original content=*Platná parita* vyžaduje, aby **všechny** disky měly původní obsah
Parity-Check in progress=Probíhá kontrola parity
ParityRead-Check History=Historie paritních/čtecích kontrol
Parity-Sync in progress=Probíhá synchronizace parity
Parity-SyncData-Rebuild in progress=Probíhá synchronizace parity / obnova dat
Partition format=Formát oddílu
Partition size=Velikost oddílu
Passed=Splněno
Passphrase=Heslová fráze
Perform full balance=Spustit úplné vyvážení
Permit UEFI boot mode=Povolit režim UEFI bootování
Please change share SMB security=Změňte nastavení zabezpečení SMB sdílení
Please check your system settings to support UEFI boot mode=Zkontroluj systémová nastavení pro podporu režimu UEFI boot
Please try again=Zkus to prosím znovu
Pool Devices=Pool – disky
Pool name already exists=Pool se zadaným názvem již existuje
Pool of %s devices=Pool z %s disků
Pool Status=Stav poolu
Power=Napájení
Preclear in progress=Probíhá mazání disku (Preclear)
previous device=Předchozí zařízení
Printable Characters Only=Pouze tisknutelné znaky
Proceed to start=Pokračovat ke spuštění
raid0=RAID0
raid1=RAID1
raid10=RAID10
raid1c3=RAID1c3
raid1c4=RAID1c4
raid5=RAID5
raid6=RAID6
raidz=RAID-Z
raidz2=RAID-Z2
raidz3=RAID-Z3
Raw Value=Hrubá hodnota
Raw View=Hrubý přehled
Read errors corrected=Opravené chyby čtení
Read errors detected=Zjištěné chyby čtení
Read-Check in progress=Probíhá kontrola čtení
Reading=Načítání
Reboot in safe mode=Restartovat v nouzovém režimu
Registration Key Manager=Správce licenčního klíče
registration key=Licenční klíč
ReiserFS is deprecated, please use another file system=ReiserFS je zastaralý, použij jiný souborový systém
reiserfsck status=Stav reiserfsck
Rename Pool=Přejmenovat pool
Renaming the pool will change the share storage allocations=Přejmenováním poolu dojde ke změně přiřazení úložiště pro sdílení
Repair corrupted blocks=Opravit poškozené bloky
Replacement disk installed=Výměnný disk nainstalován
Replacement disk is too small=Výměnný disk je příliš malý
Retype passphrase=Zadej znovu heslovou frázi
Schedule=Plán
Scrub Status=Stav scrubu
Scrub=Scrub (kontrola integrity)
See %s Settings=Viz nastavení %s
self-test in progress=Probíhá autotest
Self-Test=Autotest
Server boot mode=Režim spuštění serveru
Set default boot menu=Nastavit výchozí zaváděcí nabídku
show passphrase=Zobrazit heslovou frázi
Show=Zobrazit
single=jednoduchý
Slots=Pozice
SMART attribute notifications=SMART notifikace atributů
SMART controller type=Typ SMART řadiče
SMART error log=SMART protokol chyb
SMART extended self-test=SMART rozšířený autotest
SMART health-check failed=SMART kontrola stavu selhala
SMART notification tolerance level=SMART úroveň tolerance upozornění
SMART notification value=SMART hodnota upozornění
SMART self-test history=Historie SMART autotestů
SMART self-test in progress=Probíhá SMART autotest
SMART Settings=Nastavení SMART
SMART short self-test=SMART krátký autotest
SMART status=Stav SMART
spares - Hot Spares=rezerve – pohotovostní disky
special - Metadata storage=speciální – úložiště metadat
special - Special Allocation Class=speciální – speciální třída alokace
Speed=Rychlost
Spin down delay=Zpoždění vypnutí disku
Spin Down=Vypnout disk
Spin Up=Spustit disk
Spinup groups=Skupiny disků ke spuštění
Started, array protected=Spuštěno, pole chráněno
Started, array unprotected=Spuštěno, pole nechráněno
Started, clearing=Spuštěno, probíhá mazání
Started, formatting=Spuštěno, probíhá formátování
Starting, copying=Spouští se, probíhá kopírování
Starting=Spouští se
Stopping=Zastavuje se
Sync errors corrected=Chyby synchronizace opraveny
Sync errors detected=Zjištěny chyby synchronizace
Sync errors=Chyby synchronizace
Sync=Synchronizace
Syslinux Configuration=Konfigurace Syslinux
Syslinux configuration=Konfigurace Syslinux
Temp=Teplota
The array will be immediately available, but unprotected since parity has not been assigned=Pole bude ihned dostupné, ale **nechráněné**, protože parita není přiřazena
The array will be immediately available, but unprotected until Parity-Sync completes=Pole bude ihned dostupné, ale **nechráněné**, dokud neskončí synchronizace parity
The replacement disk must be as big or bigger than the original=Náhradní disk musí být stejně velký nebo větší než původní
The ZFS volume will be upgraded=ZFS svazek bude aktualizován
This is typically done when a new disk is added to the array to get it ready for files to be written to it=Toto se obvykle provádí při přidání nového disku do pole, aby byl připraven k zápisu dat
This operation cannot be reversed=Tuto operaci nelze vrátit zpět
This Unraid OS release has been withdrawn and may no longer be used Please=Tato verze Unraid OS byla stažena a neměla by se nadále používat. Prosím
This will ERASE ALL device content=Tímto DOCHÁZÍ KE SMAZÁNÍ VEŠKERÉHO OBSAHU zařízení
This will ERASE content of ALL devices in the pool=Tímto DOCHÁZÍ KE SMAZÁNÍ VEŠKERÉHO OBSAHU NA VŠECH ZAŘÍZENÍCH v tomto poolu
This will reboot the system=To restartuje systém
This will shutdown the system=To vypne systém
This will stop the array=To zastaví pole
This will stop the running operation=Tím se zastaví probíhající operace
Threshold=Hranice
Title=Název
To confirm type %s=Pro potvrzení zadej %s
Toggle readswrites display=Přepnout zobrazení čtení/zápisu
Too many attached devices Please consider upgrading your=Je připojeno příliš mnoho zařízení. Zvaž upgrade tvého
Too many wrong andor missing disks=Příliš mnoho chybných nebo chybějících disků
Total size=Celková velikost
Unassign ALL devices to delete this pool=Zruš přiřazení **VŠECH** zařízení pro odstranění tohoto poolu
Unassigned Devices=Nepřiřazená zařízení
Unavailable - disk must be spun up=Nedostupné – disk musí být roztočen
unavailable no parity-check entries logged=Nedostupné – žádné záznamy o kontrole parity
Unavailable=Nedostupné
Unclean shutdown detected=Zjištěno nečisté vypnutí
Unmountable disk present=Zjištěn nepřipojitelný disk
Unmountable disks present=Zjištěny nepřipojitelné disky
Unmountable Encrypted volume present=Zjištěn nepřipojitelný šifrovaný svazek
Unmountable Missing encryption key=Nelze připojit – chybí šifrovací klíč
Unmountable No file system=Nelze připojit – žádný souborový systém
Unmountable No pool uuid=Nelze připojit – chybí UUID poolu
Unmountable not btrfs pool=Nelze připojit – nejedná se o BTRFS pool
Unmountable Unsupported or no file system=Nelze připojit – nepodporovaný nebo žádný souborový systém
Unmountable Volume not encrypted=Nelze připojit – svazek není šifrovaný
Unmounted=Odpojeno
Upgrade Pool=Upgradovat pool
Upgrading diskswapping parity=Upgraduji disky / měním paritu
Use ASCII characters from space to tilde=Používej ASCII znaky od mezery po vlnovku (~)
Use Default=Použít výchozí
Use default=Použít výchozí
Use only lowercase with no special characters or leadingtrailing digits=Používej pouze malá písmena bez speciálních znaků a bez číslic na začátku/konci
use printable characters only=používej pouze tisknutelné znaky
Used=Použito
Value=Hodnota
W=W
WARNING canceling may leave the array unprotected=VAROVÁNÍ: Zrušením může zůstat pole nechráněné
Warning disk temperature threshold=Hranice varování pro teplotu disku
Warning disk utilization threshold=Hranice varování pro využití disku
Warning NVME temperature threshold=Hranice varování pro teplotu NVME
Warning SSD temperature threshold=Hranice varování pro teplotu SSD
WARNING=VAROVÁNÍ
Warranty period=Záruční doba
While there is some risk, if it is not possible to first mount the filesystem to clear the log, zeroing it is the only option to try and repair the filesystem, and in most cases it results in little or no data loss=Ačkoliv existuje určité riziko, pokud nelze souborový systém připojit pro vymazání logu, je jeho vynulování jedinou možností opravy a ve většině případů vede k malým nebo žádným ztrátám dat.
will activate a clean system power down=provede čisté vypnutí systému
will activate a clean system reset=provede čistý restart systému
will bring the array on-line and start Clearing new data disks=připojí pole a spustí mazání nových datových disků
will bring the array on-line and start Data-Rebuild=připojí pole a spustí obnovu dat
will bring the array on-line and start Disk-Clear of new data disks=připojí pole a spustí mazání nových datových disků
will bring the array on-line and start Parity-Check=připojí pole a spustí kontrolu parity
will bring the array on-line and start Parity-Sync andor Data-Rebuild=připojí pole a spustí synchronizaci parity a/nebo obnovu dat
will bring the array on-line and start Parity-Sync=připojí pole a spustí synchronizaci parity
will bring the array on-line=připojí pole
will copy the parity information to the new parity disk=zápíše informace o paritě na nový paritní disk
will create a file system in all Unmountable disks=vytvoří souborový systém na všech nepřipojitelných discích
will delete the encryption keyfile=smaže šifrovací klíč
will disable the missing disk and then bring the array on-line Install a replacement disk as soon as possible=deaktivuje chybějící disk a připojí pole. Nahraď chybějící disk co nejdříve
will expand the file system of the data disk if possible then bring the array on-line and start Data-Rebuild=pokud je to možné, rozšíří souborový systém datového disku, pak připojí pole a spustí obnovu dat
will immediately clear all disk statistics=okamžitě vymaže všechny statistiky disků
will immediately invoke the Mover=spustí přesun (Mover) okamžitě
will immediately spin down all disks=okamžitě vypne všechny disky
will immediately spin up all disks=okamžitě spustí všechny disky
will pause Data-Rebuild=pozastaví obnovu dat
will pause Disk-Clear=pozastaví mazání disku
will pause Parity-Check=pozastaví kontrolu parity
will pause Parity-Sync=pozastaví synchronizaci parity
will pause Read-Check=pozastaví kontrolu čtení
will pause the Clearing=pozastaví mazání
will pause the Parity-Check=pozastaví kontrolu parity
will pause the Parity-SyncData-Rebuild=pozastaví synchronizaci parity a obnovu dat
will pause the Read-Check=pozastaví kontrolu čtení
will record all disk information and bring the array on-line=uloží informace o všech discích a připojí pole
will record all disk information, bring the array on-line, and start Parity-Sync=uloží informace o všech discích, připojí pole a spustí synchronizaci parity
will remove the missing cache disk and then bring the array on-line=odstraní chybějící cache disk a připojí pole
will remove the missing pool disk and then bring the array on-line=odstraní chybějící disk z poolu a připojí pole
will resume Data-Rebuild=obnoví obnovu dat
will resume Disk-Clear=obnoví mazání disku
will resume Parity-Check=obnoví kontrolu parity
will resume Parity-Sync=obnoví synchronizaci parity
will resume Read-Check=obnoví kontrolu čtení
will resume the paused Clearing=obnoví pozastavené mazání
will resume the paused Parity-Check=obnoví pozastavenou kontrolu parity
will resume the paused Parity-SyncData-Rebuild=obnoví pozastavenou synchronizaci parity / obnovu dat
will resume the paused Read-Check=obnoví pozastavenou kontrolu čtení
will start Clearing new data disks=zahájí **mazání** nových datových disků
will start Data-Rebuild=zahájí **obnovu dat**
will start Disk-Clear of new data disks=zahájí **vymazání disků** pro nové datové disky
will start Parity-Check=zahájí **kontrolu parity**
will start Parity-Sync andor Data-Rebuild=zahájí **synchronizaci parity** a/nebo **obnovu dat**
will start Parity-Sync=zahájí **synchronizaci parity**
will start Read-Check of all array disks=zahájí **kontrolu čtení** všech disků v poli
will stop Clearing=zastaví mazání
will stop Data-Rebuild=zastaví obnovu dat
will stop Disk-Clear=zastaví vymazání disku
will stop Parity-Check=zastaví kontrolu parity
will stop Parity-Sync=zastaví synchronizaci parity
will stop Parity-SyncData-Rebuild=zastaví synchronizaci parity / obnovu dat
will stop Read-Check=zastaví kontrolu čtení
will stop the Parity-Check=zastaví kontrolu parity
will stop the Read-Check=zastaví kontrolu čtení
will take the array off-line=odpojí pole (array)
Worst=Nejhorší
Write corrections to parity=zapsat opravy do parity
Writes=Zápisy
Wrong key=Nesprávný klíč
Wrong Pool State=Neplatný stav poolu
xfs_repair status=stav opravy xfs
You may not add new disks and also remove existing disks=Nelze současně přidávat nové a odebírat stávající disky
your server=tvůj server
Zero Log=vynulovat log
zfs pool status=stav ZFS poolu
zfs=ZFS

; Sleep plugin translations
Check this=Zkontroluj toto
for more information=pro více informací
Make sure your server supports S3 sleep=Ujisti se, že tvůj server podporuje režim spánku S3
Sleep will immediately put the server in sleep mode=**Režim spánku** okamžitě přepne server do spánkového režimu
Sleeping=Spí
System in sleep mode=Systém je v režimu spánku
This will put the system in sleep mode=Tím se systém přepne do režimu spánku
wiki entry=Záznam na Wikipedi
