%s An update is available=%s: Aktualizace je k dispozici
Alert Message=Upozornění
anonymous=Anonymní
Author=Autor
cannot check=nelze ověřit
Check For Updates=Zkontrolovat aktualizace
Checking connectivity=Kontroluje se připojení
checking=Kontroluji
Click here to install version %s=Klikněte zde pro instalaci verze %s
Delete Plugin=Odstranit plugin
DOWNGRADE TO VERSION=VRÁTIT NA VERZI
Enter URL of remote plugin file or local plugin file=Zadejte URL vzdáleného pluginu nebo vyberte místní soubor pluginu
ERROR=CHYBA
I have read the release notes=Přečetl(a) jsem si poznámky k vydání
Install Plugin=Instalovat plugin
Install=Instalovat
install=instalovat
Installed Plugins=Nainstalované pluginy
Installing Update=Instaluje se aktualizace
need check=vyžaduje ověření
Next=Další
No plugins installed=Žádné pluginy nejsou nainstalovány
No release notes available=Poznámky k vydání nejsou dostupné
No response, aborting=Žádná odpověď, přerušeno
Plugin File Install Errors=Chyby při instalaci souboru pluginu
Plugin File=Soubor pluginu
Plugin History=Historie pluginů
Plugin Update Check=Kontrola aktualizací pluginů
Plugin=Plugin
Release Notes=Poznámky k vydání
Remove Plugin=Odstranit plugin
Remove Selected Plugins=Odstranit vybrané pluginy
remove=odstranit
Select local plugin file=Vyberte místní soubor pluginu
Stable=Stabilní
STALE=ZASTARALÉ
Support Thread=Vlákno podpory
Uninstall=Odinstalovat
Update All Plugins=Aktualizovat všechny pluginy
Update Incompatible=Aktualizace není kompatibilní
Update Plugin=Aktualizovat plugin
Upgrade=Upgrade
View Release Notes=Zobrazit poznámky k vydání
