%s ago=před %s
%s is out of range minimum 1 maximum 65535=%s je mimo rozsah (minimálně 1, maximálně 65535)
12 hours=12 hodin
24 hours=24 hodin
8023ad=802.3ad
a value of zero means no automatic closure=hodnota nula znamená žádné automatické uzavření
Accumulation duration=Doba kumulace
Accumulation frequency=Frekvence kumulace
Activate=Aktivovat
Activated=Aktivováno
Activating=Aktivace
Active Directory Settings=Nastavení Active Directory
Active Directory=Active Directory
active-backup=aktivní-záloha
AD account login=Přihlašovací jméno AD
AD account password=Heslo k AD
AD domain name=Doména AD
AD initial group=Úvodní skupina AD
AD initial owner=Úvodní vlastník AD
AD join status=Stav připojení k AD
AD short domain name=Zkrácený název domény AD
Add Peer=Přidat Peer
Add Route=Přidat směrování (route)
Add Tunnel=Přidat tunel
Add VLAN=Přidat VLAN
Advanced=Pokročilé
Agent function=Funkce agenta
Agents=Agenti (notifikací)
Alerts=Upozornění
Allocation profile=Profil přidělení
Allow Remote Access=Povolit vzdálený přístup
Allow=Povolit
Always On - Manual Port Forward=Vždy zapnuto – ruční přesměrování portů
Always On - UPnP=Vždy zapnuto – UPnP
and, the first and last characters must be alphanumeric=a první a poslední znak musí být alfanumerický
and=a
Any=Libovolný
APC UPS Daemon user manual=Uživatelská příručka APC UPS démona
APCsmart=APCsmart
Apply to activate Docker after Array is Started=Použít pro aktivaci Dockeru po spuštění Array
Apply to activate VMs after Array is Started=Použít pro aktivaci virtuálních strojů po spuštění Array
Applying=Používá se
Array must be Stopped to change=Pro změny musí být Array **zastaven**
Array status notification=Notifikace o stavu Array
Array status=Stav Array
Assignment error=Chyba přiřazení
Attention=Pozor
Attribute=Atribut
Authentication method=Metoda autentizace
auto=automaticky
Auto-close=Automatické zavření
automatic=automaticky
Autostart=Automatické spuštění
Available notifications=Dostupná oznámení
bad or missing key file=chybný nebo chybějící licenční soubor
Balance schedule=Plán vyvážení
balance-alb=balance-alb
Balanced operation=Vyvážený provoz
balance-rr=balance-rr
balance-tlb=balance-tlb
balance-xor=balance-xor
Bar color - Text=Barva pruhu – Text
Bar color=Barva pruhu
Bar gray - Text=Šedý pruh – Text
Bar gray=Šedý pruh
Basic=Základní
Battery Charge=Nabíjení baterie
Battery level to initiate shutdown=Úroveň baterie pro spuštění vypnutí
Best performance=Nejlepší výkon
Best power efficiency=Nejlepší energetická účinnost
bfq=bfq
Block group usage=Využití skupiny bloků
Bonding members of=Členové agregace síťových karet
Bonding mode=Režim agregace
boost=zvýšit
Both Web Virt-Manager Remote Viewer=Oba: Web & vzdálený přístup Virt-Manager
Both=Obojí
bottom-left=levý dolní roh
bottom-right=pravý dolní roh
Boxed=Orámované
Bridging members of=Členové síťového mostu
broadcast=Broadcast
Browser=Prohlížeč
btrfs filesystem show=Zobrazit Btrfs souborový systém
btrfs scrub status=Stav Btrfs kontroly (scrub)
btrfs vDisk=btrfs vDisk
Cache disk not enabled=Cache disk není povolen
Cache Settings=Nastavení cache
Cannot provision cert that would overwrite your existing custom cert at=Nelze vystavit certifikát, který by přepsal tvůj vlastní certifikát na
Cannot renew a custom cert at=Nelze obnovit vlastní certifikát na
Cannot renew cert until within 30 days of expiry=Certifikát lze obnovit pouze 30 dní před vypršením platnosti
CA-signed certificate file=Certifikát podepsaný autoritou (CA)
Caution=Pozor
Celsius=Celsius
center=střed
Certificate expiration=Vypršení certifikátu
Certificate issuer=Vystavitel certifikátu
Certificate not valid for=Certifikát není platný pro
Certificate subject=Subjekt certifikátu
Certificate URL=URL certifikátu
Certificate will not renew unless you are signed in to Unraidnet=Certifikát se neobnoví, pokud nejsi přihlášen k Unraid.net
Change encryption key=Změnit šifrovací klíč
Change power mode=Změnit režim napájení
Changes=Změny
Changing key failed for disks=Změna klíče pro disky selhala
Check cable=Zkontroluj kabel
Check four times a day=Kontrola čtyřikrát denně
Check once a day=Kontrola jednou denně
Check once a month=Kontrola jednou měsíčně
Check once a week=Kontrola jednou týdně
Check twice a day=Kontrola dvakrát denně
Checking=Kontroluji
CIDR optional=CIDR volitelně
Click here to see the Unraid Wiki for more information=Klikni zde pro více informací v Unraid Wiki
Click to invoke the Mover=Klikni pro spuštění přesunu (Mover)
Click to select PNG file=Klikni pro výběr PNG souboru
Click to Select=Klikni pro výběr
Comma separated list of IPv4 and IPv6 IP addresses=Seznam IPv4 a IPv6 adres oddělených čárkou
configure your router with a static route of=Konfiguruj směrovač se statickou trasou:
configure your router with port forwarding of port=Nastav přesměrování portu v routeru na port
configuring interface=Konfiguruji rozhraní
Confirm array stop command=Potvrdit příkaz ke zastavení pole
Confirm reboot powerdown commands=Potvrdit příkaz k restartu/vypnutí
Confirm sleep command=Potvrdit příkaz k uspání
Confirmations=Potvrzení
connect to any device on the VPN tunnel=Připojit se k libovolnému zařízení v rámci VPN tunelu
connect to this server using IP address=Připojit se k tomuto serveru pomocí IP adresy
Connected to Unraid Connect Cloud=Připojeno ke cloudu Unraid Connect
Console Options=Možnosti konzole
Console Settings=Nastavení konzole
Container=Kontejner
Content=Obsah
Copy syslog to flash on shutdown=Zkopírovat systémový log na flash při vypnutí
Correct file system errors=Opravit chyby souborového systému
CPU Isolation A reboot is required to apply changes=Izolace CPU: Pro použití změn je vyžadován restart
CPU isolation is prohibited while system is running in SAFE MODE=Izolace CPU není povolena při běhu v nouzovém režimu
CPU Isolation=Izolace CPU
CPU Pinning Docker=Přiřazení CPU pro Docker
CPU Pinning VM=Přiřazení CPU pro VM
CPU Pinning=Přiřazení CPU
CRAM-MD5=CRAM-MD5
Cumulative parity check=Kumulativní kontrola parity
Current date and time=Aktuální datum a čas
Current listening interfaces=Aktuálně naslouchající rozhraní
Current usage ratio=Aktuální poměr využití
Custom attributes use comma to separate numbers=Vlastní atributy – použij čárku k oddělení čísel
Custom banner=Vlastní banner
Custom UPS cable=Vlastní kabel UPS
Custom=Vlastní
custom=vlastní
D comma G dot=D čárka : G tečka
D comma G none=D čárka : G nic
D comma G space=D čárka : G mezera
D dot G comma=D tečka : G čárka
D dot G none=D tečka : G nic
D dot G space=D tečka : G mezera
Daily=Denně
Data received=Přijatá data
Data sent=Odeslaná data
Date and Time=Datum a čas
Date format=Formát datumu
Day of the month=Den v měsíci
Day of the week=Den v týdnu
Day, D Month YYYY=Den, D Měsíc RRRR
Day, DD.MM.YYYY=Den, DD.MM.RRRR
Day, DD-MM-YYYY=Den, DD-MM-RRRR
Day, MMDDYYYY=Den, MMDDRRRR
Day, Month D, YYYY=Den, Měsíc D, RRRR
Day, YYYY Month D=Den, RRRR Měsíc D
Day, YYYY-MM-DD=Den, RRRR-MM-DD
DD-MM-YYYY=DD-MM-RRRR
Deactivate=Deaktivovat
Deactivating=Deaktivace
Default appdata storage location=Výchozí umístění pro appdata
Default critical disk temperature threshold=Výchozí mezní hodnota pro kritickou teplotu disku
Default critical disk utilization threshold=Výchozí mezní hodnota pro kritické využití disku
Default critical SSD temperature threshold=Výchozí mezní hodnota pro kritickou teplotu SSD
Default file system for Array disks=Výchozí souborový systém pro disky pole
Default ISO storage path=Výchozí cesta pro ukládání ISO
Default network bridge=Výchozí síťový most
Default network source=Výchozí síťový zdroj
Default partition format=Výchozí formát oddílu
Default SMART attribute notifications=Výchozí SMART upozornění
Default SMART controller type=Výchozí typ SMART řadiče
Default SMART notification tolerance level=Výchozí úroveň tolerance SMART upozornění
Default SMART notification value=Výchozí hodnota pro SMART upozornění
Default spin down delay=Výchozí prodleva pro uspání disku
Default VM storage path=Výchozí cesta pro ukládání VM
Default warning disk temperature threshold=Výchozí mezní hodnota pro varování o teplotě disku
Default warning disk utilization threshold=Výchozí mezní hodnota pro varování o využití disku
Default warning SSD temperature threshold=Výchozí mezní hodnota pro varování o teplotě SSD
Default Windows VirtIO driver ISO=Výchozí ISO soubor ovladačů VirtIO pro Windows
Define a TLS certificate=Definuj TLS certifikát
Delete directory=Smazat adresář
Delete Image File=Smazat soubor image
Delete Peer=Smazat peer
Delete tunnel failed=Smazání tunelu selhalo
Delete Tunnel=Smazat tunel
Delete vDisk file=Smazat vDisk soubor
Delete VLAN=Smazat VLAN
Deny=Odmítnout
Desired MTU=Požadovaná MTU
Detailed=Podrobně
Device=Zařízení
DHCP pool=DHCP rozsah
directory=adresář
Disable AutostartStart option for VMs=Zakázat volbu automatického spuštění pro VM
Disabled until connected to Unraid Connect Cloud=Zakázáno do připojení ke službě Unraid Connect Cloud
Disk Settings=Nastavení disku
Display array totals=Zobrazit celkové hodnoty pole
Display device name=Zobrazit název zařízení

Display position=Zobrazit pozici
Display Settings=Nastavení zobrazení
Display width=Šířka zobrazení
Display world-wide-name in device ID=Zobrazit World-Wide-Name v ID zařízení
DNS Propagation is PENDING=DNS propagace PROBÍHÁ
DNS Rebinding Protection is ENABLED=Ochrana proti DNS Rebindu je ZAPNUTA
DNS servers=DNS servery
docker containers on custom networks need static routing=Docker kontejnery v uživatelských sítích vyžadují statické směrování
Docker custom network type=Typ vlastní sítě Dockeru
Docker data-root=Kořenový adresář pro Docker data
Docker directory=Docker adresář
Docker LOG maximum file size=Maximální velikost Docker log souboru
Docker LOG number of files=Počet Docker log souborů
Docker LOG rotation=Rotace Docker log souborů
Docker only=Pouze Docker
Docker PID Limit=Limit PID pro Docker
Docker service=Docker služba
Docker Stop Timeout=Časový limit pro zastavení Docker kontejneru
Docker storage driver=Ovladač úložiště Dockeru
Docker update notification=Upozornění na aktualizaci Docker kontejneru
Docker update=Aktualizace Docker kontejneru
Docker vDisk location=Umístění Docker vDisku
Docker vDisk size=Velikost Docker vDisku
Docker version=Verze Dockeru
Docker VMs=Docker + Virtuální stroje
Docker volume info=Informace o Docker svazku
Docker will be available after Array is Started=Docker bude dostupný po spuštění pole
Docker=Docker
Dont show RDP option=Nezobrazovat možnost RDP
download error=Chyba při stahování
Download Windows VirtIO driver ISO=Stáhnout ISO ovladačů Windows VirtIO
Downloading=Stahuji
Downstream=Směrem dolů
Drag-n-drop a PNG file or click the image at the left=Přetáhni soubor PNG nebo klikni na obrázek vlevo
Dumb=Bez zvuku
Duplicate port entered=Zadaný port je duplicitní
Dynamix color theme=Barevné schéma Dynamix
eg=např.
Email recipients=Příjemci e-mailu
Email subject prefix=Předpona předmětu e-mailu
Email=E-mail
enable advanced settings view=Zobrazit pokročilá nastavení
Enable auto start=Povolit automatické spuštění
Enable bonding=Povolit spojování síťových rozhraní
Enable bridging=Povolit síťový můstek
Enable container table readmore-js=Povolit Readmore-js v tabulce kontejnerů
Enable disk shares=Povolit sdílení disků
Enable Docker=Povolit Docker
Enable NetBIOS=Povolit NetBIOS
Enable NFS=Povolit NFS
Enable NVME power monitoring=Povolit sledování spotřeby NVME
Enable Outgoing Proxy=Povolit odchozí proxy
Enable SMB Multi Channel=Povolit SMB Multi-Channel
Enable SMB=Povolit SMB
Enable spinup groups=Povolit skupiny pro roztočení disků
Enable user shares=Povolit sdílení uživatelských složek
Enable VLANs=Povolit VLANy
Enable VMs=Povolit virtuální stroje
Enable WSD=Povolit WSD (Web Services for Devices)
encrypted=Šifrováno
Encryption Key Update=Aktualizace šifrovacího klíče
Enhanced macOS interoperability=Zlepšená kompatibilita s macOS
ensure the peer network is different from=ujisti se, že partnerská síť se liší od
ensure the peer networks are different from=ujisti se, že partnerské sítě se liší od
Ensure the primary network card eth0 has an IP address=Ujisti se, že hlavní síťová karta eth0 má přiřazenou IP adresu
Enter existing passphrase=Zadej existující heslovou frázi
Enter route + gateway + metric=Zadej trasu, bránu a metriku
Erase Pool=Smazat pool
Ether=Ether
Ethernet Port=Ethernetový port
Event=Událost
Every 2 hours=Každé 2 hodiny
Every 3 hours=Každé 3 hodiny
Every 4 hours=Každé 4 hodiny
Every 6 hours=Každých 6 hodin
Every 8 hours=Každých 8 hodin  
Every day=Každý den  
Every hour=Každou hodinu  
Every month=Každý měsíc  
Every week=Každý týden  
exceeds Disk Shutdown=Překračuje čas pro uspání disku  
Exclude listening interfaces=Vyloučit naslouchající rozhraní  
Excluded disks=Vyloučené disky  
Execution error=Chyba při vykonávání  
Existing encryption key=Existující šifrovací klíč  
Fahrenheit=Fahrenheit
Failed to open=Chyba při otevírání
Failed to stop=Chyba při zastavování
Failure to do so may result in your docker image suffering corruption at a later time=Neprovedení může mít za následek pozdější porušení obrazu Dockeru
Fast=Rychlý
Favorites enabled=Oblíbené povoleny
File system corruption fixed=Poškození souborového systému opraveno
Finished=Dokončeno
First day=První den
First week=První týden
Flash backup=Záloha flash disku
Font size=Velikost písma
Fourth week=Čtvrtý týden
FTP server=FTP server
FTP Server=FTP server
FTP users=FTP uživatelé
Full Balance recommended=Doporučeno úplné vyvážení
gateway name or address=Název nebo adresa brány
Gateway=Brána
Generate Key=Generovat klíč
Generate Keypair=Generovat pár klíčů
Global Share Settings=Globální nastavení sdílení
Global SMART Settings=Globální nastavení SMART
GRUB Configuration=Konfigurace GRUB
Hardware=Hardware
Header custom background color=Vlastní barva pozadí záhlaví
Header custom meta text color=Vlastní barva metatextu záhlaví
Header custom secondary text color=Vlastní barva vedlejšího textu záhlaví
Header custom text color=Vlastní barva textu záhlaví
Header menu=Nabídka záhlaví
Header show description=Zobrazit popis v záhlaví
HHMM=HH:MM
Hibernate VMs=Uspat virtuální stroje (hibernate)
Hidden share names are not allowed=Skryté názvy sdílení nejsou povoleny
Hide dot files=Skrýt soubory začínající tečkou
Host access to custom networks=Přístup hostitele do vlastních sítí
hosts=Hostitelé
Hourly=Každou hodinu
HTML color code of 3 or 6 hexadecimal digits=HTML barva (3 nebo 6 hexadecimálních znaků)
HTTP port=HTTP port
HTTPS port=HTTPS port
Huge=Obrovský
Identification=Identifikace
IEEE 8023=IEEE 802.3
if you have trouble logging in, close all other tabs pointing to this server and clear your browsers cache=Pokud máte problémy s přihlášením, zavřete všechny ostatní panely směřující na tento server a vymažte mezipaměť prohlížeče
Import Tunnel=Importovat tunel
Importance=Důležitost
In most cases, this should be your public WAN IPv4 instead=Ve většině případů by to měla být vaše veřejná IPv4 adresa WAN
In most cases, this should be your public WAN IPv4=Ve většině případů je to vaše veřejná IPv4 adresa WAN
In most cases, this should be your public WAN IPv6 instead=Ve většině případů by to měla být vaše veřejná IPv6 adresa WAN
In most cases, this should be your public WAN IPv6=Ve většině případů je to vaše veřejná IPv6 adresa WAN
inactive=Neaktivní
Include listening interfaces=Zahrnout naslouchací rozhraní
Included disks=Zahrnuté disky
Incorrect existing key=Nesprávný existující klíč
Input a IPv4 address=Zadejte IPv4 adresu
Input a IPv6 address=Zadejte IPv6 adresu
Input a MAC address=Zadejte MAC adresu
Input a NTP server name, NTP pool name or IP address=Zadejte název NTP serveru, název NTP poolu nebo IP adresu
Input the correct date and time manually=Zadejte správné datum a čas ručně
Interface description=Popis rozhraní
Interface Extra=Další rozhraní
Interface Rules=Pravidla rozhraní
Invalid data=Neplatná data
Invalid email address=Neplatná e-mailová adresa
Invalid IPv4 gateway=Neplatná IPv4 brána
Invalid IPv4 range=Neplatný rozsah IPv4
Invalid IPv4 subnet=Neplatná IPv4 podsíť
Invalid IPv6 gateway=Neplatná IPv6 brána
Invalid IPv6 range=Neplatný rozsah IPv6
Invalid IPv6 subnet=Neplatná IPv6 podsíť
Invalid pool address=Neplatná adresa fondu
Invalid subnet size=Neplatná velikost podsítě
IP address or FQDN=IP adresa nebo FQDN
IP Address=IP adresa
IPv4 address A.B.C.D=IPv4 adresa (A.B.C.D)
IPv4 address assignment=Přiřazení IPv4 adresy
IPv4 address=IPv4 adresa
IPv4 custom network on interface=Vlastní IPv4 síť na rozhraní
IPv4 default gateway=Výchozí IPv4 brána
IPv4 DNS server assignment=Přiřazení IPv4 DNS serveru
IPv4 DNS server=IPv4 DNS server
IPv4 IPv6=IPv4/IPv6
IPv4 network=IPv4 síť
IPv4 only=Pouze IPv4
IPv4nn or IPv6nn route=IPv4/nn nebo IPv6/nn trasa
IPv6 address assignment=Přiřazení IPv6 adresy
IPv6 address nnnnxxxxyyyy=IPv6 adresa (nnnn:xxxx::yyyy)
IPv6 address=IPv6 adresa
IPv6 custom network on interface=Vlastní IPv6 síť na rozhraní
IPv6 default gateway=Výchozí IPv6 brána
IPv6 DNS server assignment=Přiřazení IPv6 DNS serveru
IPv6 DNS server=IPv6 DNS server
IPv6 network=IPv6 síť
IPv6 only=Pouze IPv6
IPv6 privacy extensions=Rozšíření ochrany soukromí pro IPv6
ipvlan=ipvlan
is a self-signed certificate, ignore the browsers warning and proceed to the GUI=Jedná se o svépodepsaný certifikát – ignorujte varování prohlížeče a pokračujte do GUI
is a self-signed certificate, ignore the browsers warning when using this certificate=Jedná se o svépodepsaný certifikát – ignorujte varování prohlížeče při jeho použití
is down=je nedostupné
is not in the=není v
is only available when the filesyestem is mounted=je dostupné pouze, když je souborový systém připojen
Isolated CPUs=Izolovaná jádra CPU
Isolation=Izolace
Join=Připojit se
Key successfully changed=Klíč úspěšně změněn
Key=Klíč
Keyfile=Soubor s klíčem
kyber=kyber
LAN hub spoke access=Přístup LAN Hub-Spoke
LAN to LAN access=LAN do LAN přístup
Language update notification=Upozornění na aktualizaci jazyka
Language update=Aktualizace jazyka
Language=Jazyk
Large=Velký
Last day=Poslední den
Last handshake=Poslední handshake
Last week=Minulý týden
LE Cert Provisioned successfully=LE certifikát byl úspěšně vystaven
Leave=Opustit
Libvirt Log=Libvirt protokol
Libvirt storage location=Úložiště Libvirt
Libvirt vdisk size=Velikost Libvirt vDisk
Libvirt version=Verze Libvirt
Libvirt volume info=Informace o svazku Libvirt
License key required=Vyžadován licenční klíč
List of peers=Seznam peerů
List of VLANs contains duplicate VLAN numbers=Seznam VLAN obsahuje duplicitní čísla VLAN
Listing height=Výška seznamu
Loading=Načítání
Local access URLs=Místní přístupové adresy
Local endpoint=Místní koncový bod
Local gateway uses UPnP=Místní brána používá UPnP
Local keyboard layout=Místní rozložení klávesnice
Local master=Místní hlavní uzel
Local name=Místní název
Local private key=Místní soukromý klíč
Local public key=Místní veřejný klíč
Local screen blank time=Doba vypnutí místní obrazovky
Local server configuration=Konfigurace místního serveru
Local server uses NAT=Místní server používá NAT
Local syslog folder=Místní složka pro systémové protokoly
Local syslog maximum file size=Maximální velikost souboru místního systémového protokolu
Local syslog number of files=Počet souborů místního systémového protokolu
Local syslog port=Port pro místní systémový protokol
Local syslog rotation=Rotace místních systémových protokolů
Local syslog server=Místní syslog server
Local TLD=Místní TLD
Local tunnel address IPv6=IPv6 adresa místního tunelu
Local tunnel address=Adresa místního tunelu
Local tunnel firewall=Firewall místního tunelu
Local tunnel network pool IPv6=IPv6 rozsah místní tunelové sítě
Local tunnel network pool=Rozsah místní tunelové sítě
Lost communication=Spojení ztraceno
Low on battery=Slabá baterie
MAC address mismatch=Neodpovídající MAC adresa
MAC address=MAC adresa
macvlan=macvlan
Mail server port=Port poštovního serveru
Mail server=Poštovní server
Make sure you understand what you are doing before enabling=Ujisti se, že rozumíš důsledkům před aktivací této funkce
Manage password=Spravovat heslo
Manage=Spravovat
Management Access=Přístup k administraci
Management Interface=Správní rozhraní
mandatory=povinné
Manual=Manuál
Medium=Střední
member of=člen skupiny
Metric=Metrika
Mirror syslog to flash=Zrcadlit systémový protokol na flash disk
Misconfiguration can cause problems=Špatná konfigurace může způsobit problémy
Missing new key=Chybí nový klíč
Missing subnet size=Chybí velikost podsítě
MM-DD-YYYY=MM-DD-RRRR
ModBus=ModBus
Modify with caution unable to validate path until Array is Started=Upravuj s opatrností – cesta nebude ověřena, dokud není Array spuštěn
Month of the year=Měsíc v roce
Monthly=Měsíčně
Move now=Přesunout nyní
Mover is running=Mover běží
Mover logging=Protokolování Moveru
Mover schedule=Plán Moveru
Mover Settings=Nastavení Moveru
mq-deadline=mq-deadline
MTU size=Velikost MTU
Multicast=Multicast
Multi-function=Více funkcí
Must be signed in to Unraidnet to provision cert=Pro vystavení certifikátu musíš být přihlášen k Unraid.net
name or ip address=Název nebo IP adresa
native=Native
Net=Síť
Network protocol=Síťový protokol
Network Services=Síťové služby
Network Settings=Nastavení sítě
Never check=Nikdy nekontrolovat
Never send=Nikdy neposílat
New date and time=Nové datum a čas
NFS=NFS
No Balance required=Není potřeba vyvážení (balance)
No battery detected=Nebyla detekována žádná baterie
No Cache device present=Žádné cache zařízení není přítomno
No Cache disk present=Žádný cache disk není přítomen
No change to report=Žádné změny k zaznamenání
No CPU pinning available. Docker service must be started=CPU přiřazení není dostupné. Služba Docker musí být spuštěna
No CPU pinning available. VM service must be started=CPU přiřazení není dostupné. Služba VM musí být spuštěna
no name=Žádné jméno
No Parity disk present=Chybí paritní disk
No Reply=Žádná odpověď
No suitable interfaces found for PTP=Žádné vhodné rozhraní pro PTP nebylo nalezeno
Nominal Power=Jmenovitý výkon
Non-tabbed=Bez záložek
Not activated=Neaktivováno
Not allowed to assign ZERO cores=Není povoleno přiřadit NULA jader
Not compatible with NetBIOS=Nekompatibilní s NetBIOS
not configured=není nakonfigurováno
Not present=Není přítomen
not received=Nepřijato
not set=Nenastaveno
Not up-to-date=Není aktuální
not used=Nepoužívá se
Note=Poznámka
Nothing to do=Není co dělat
Notices=Upozornění
Notification Agents=Notifikační agenti
Notification entity=Notifikační entita
Notification Settings=Nastavení upozornění
Notifications display=Zobrazení upozornění
NTP interval=NTP interval
NTP server=NTP server
NTP=NTP
Number format=Formát čísel
Number scaling=Zobrazení velikostí souborů
Obtaining DNSv4 server=Získávání DNSv4 serveru
Obtaining DNSv6 server=Získávání DNSv6 serveru
Obtaining IPv4 address=Získávání IPv4 adresy
Obtaining IPv4 gateway=Získávání IPv4 brány
Obtaining IPv6 address=Získávání IPv6 adresy
Obtaining IPv6 gateway=Získávání IPv6 brány
obtaining=Získávání
On battery=Na baterii
One or more paths do not exist=Jeden nebo více cest neexistuje
Online=Online
Only alphanumeric characters=Pouze alfanumerické znaky
Only modify if this is a new installation since this can lead to unwanted behaviour=Upravuj pouze v případě nové instalace, protože to může vést k nežádoucímu chování
Only PNG images are allowed=Povoleny jsou pouze PNG obrázky
Oops=Jejda
optional metric lowest is preferred, 0 is no default gateway=Volitelná metrika (nižší číslo je preferováno, 0 znamená žádná výchozí brána)
optional metric lowest is preferred=Volitelná metrika (nižší číslo je preferováno)
Optional=Volitelné
or=nebo
Outgoing Proxy Manager=Správce odchozího proxy
Outgoing Proxy=Odchozí proxy
Output Voltage=Výstupní napětí
overlay2=overlay2
Override UPS Capacity Watts=Nahradit kapacitu UPS (W)
Page view=Zobrazení stránky
Parity Check=Kontrola parity
Passphrase=Heslová fráze
Password=Heslo
Path does not exist=Cesta neexistuje
PCIe ACS override=Vynutit PCIe ACS
PCnet=PCnet
Peer allowed IPs=Povolené IP adresy peeru
Peer DNS server=DNS server peeru
Peer endpoint=Koncový bod peeru
Peer name=Název peeru
Peer preshared key=Předem sdílený klíč peeru
Peer private key=Soukromý klíč peeru
Peer public key=Veřejný klíč peeru
Peer tunnel address IPv6=IPv6 adresa tunelu peeru
Peer tunnel address=Adresa tunelu peeru
Peer type of access=Typ přístupu peeru
Peer update required=Vyžadována aktualizace peeru
Perform TRIM Operation=Proveď TRIM operaci
Permit exclusive shares=Povolit exkluzivní sdílení
Persistent Bash History=Trvalá historie Bash
Persistent keepalive=Trvalé keepalive
Ping=Ping
Placement of Users menu=Umístění nabídky Uživatelé
Please consider re-applying all configurations=Zvaž opětovné použití všech konfigurací
Please disable the VM function=Prosím deaktivuj funkci virtuálních strojů
Please do this NOW=Prosím proveď to TEĎ
Please enter a valid gateway=Zadej platnou výchozí bránu
Please enter a valid range=Zadej platný rozsah
Please enter a valid sending email address=Zadej platnou e-mailovou adresu odesílatele
Please enter a valid subnet=Zadej platnou podsíť
Please match the requested format=Prosím dodrž požadovaný formát
Please note that the flash backup is not encrypted at this time=Vezmi na vědomí, že záloha flash disku není v tuto chvíli šifrována
Please read the Help carefully=Prosím pečlivě si přečti nápovědu
Please Reboot system to make new rules active=Prosím restartuj systém, aby se nové pravidla aktivovala
Please Stop array to complete key installation=Prosím zastav pole (array), aby bylo možné dokončit instalaci klíče
Plugins update notification=Oznámení o aktualizaci pluginů
Plugins update=Aktualizace pluginů
Pool address is out of range=Adresa poolu je mimo povolený rozsah
pool device stats=Statistiky zařízení v poolu
Pool Device Status=Stav zařízení v poolu
Pool Information=Informace o poolu
Pool subnet size is not defined=Velikost podsítě poolu není definována
Pool subnet size is too large=Velikost podsítě poolu je příliš velká
Port %s is already in use by other services=Port %s je již používán jinými službami
Port %s is duplicated=Port %s je duplicitní
Port %s is out of range minimum 1 maximum 65535=Port %s je mimo rozsah (1 až 65535)
Port already in use=Port je již používán
Port Down=Port deaktivován
Port out of range=Port mimo rozsah
Port Up=Port aktivován
Power Mode=Režim napájení
Preserve user defined networks=Zachovat uživatelské sítě
Preset service=Přednastavená služba
Priority in header=Priorita v hlavičce
Protocol=Protokol
Provision=Vystavit (např. certifikát)
PTP clock=PTP hodiny
PTP interface=PTP rozhraní
PTP mode=PTP režim
PTP profile=PTP profil
PTP server=PTP server
PTP transport=PTP přenos
PTP=PTP
QEMU version=QEMU verze
Questions See the documentation=Dotazy? Viz <a href="https://wiki.unraid.net/Connect" target="_blank">dokumentaci</a>
raidz1=raidz1
readmodifywrite=Čtení/Upravení/Zápis
recommended=Doporučeno
reconstruct write=Rekonstrukční zápis
redirects to=Přesměrovává na
Refreshing=Obnovuji
Registration key required=Vyžadován licenční klíč
Reinitialize=Znovu inicializovat
Reinitializing=Inicializuji znovu
Remark configure your router with port forwarding of port=Poznámka: nakonfiguruj směrovač s přesměrováním portu
Remark to use the Dynamic - Manual Port Forward option for Remote Access please set Use SSLTLS to Strict in Management Access=Poznámka: Pro použití „Dynamické – ruční přesměrování portu“ pro vzdálený přístup nastav v přístupu ke správě SSL/TLS na „Přísné“
Remark to use the UPnP options please set Use UPnP to Yes in Management Access=Poznámka: Pro použití UPnP nastav v přístupu ke správě „Použít UPnP“ na „Ano“
Remark=Poznámka
Remote access to LAN=Vzdálený přístup k LAN
Remote access to server=Vzdálený přístup k serveru
Remote peer configuration=Konfigurace vzdáleného peeru
Remote syslog port=Port vzdáleného systémového logu
Remote syslog server=Vzdálený systémový log server
Remote tunneled access=Tunelovaný vzdálený přístup
Remove pool=Odstranit pool
Remove Pool=Odstranit pool
Remove Windows VirtIO driver ISO=Odstranit Windows VirtIO driver ISO
Replied=Odpovězeno
Required=Vyžadováno
resolution=Rozlišení
Restore default image=Obnovit výchozí image
Retype new passphrase=Znovu zadej novou heslovou frázi
Route=Trasa
Routing Table=Směrovací tabulka
Rule=Pravidlo
Rules contain duplicate MAC address assignments=Pravidla obsahují duplicitní přiřazení MAC adres
Rules=Pravidla
Runtime left to initiate shutdown=Zbývající čas do vypnutí
Runtime Left=Zbývající čas
Samba extra configuration=Dodatečná konfigurace Samby
Scheduled parity check=Naplánovaná kontrola parity
Scheduler=Plánovač
Scrub schedule=Plán pro Scrub
Scrub Schedule=Plán Scrubu
Scrub=Scrub
Second week=Druhý týden
See Help for more details and workarounds=Viz nápovědu pro více detailů a řešení
see interface=viz rozhraní
Select existing keyfile=Vyber existující soubor s klíčem
Select new keyfile=Vyber nový soubor s klíčem
Select Proxy=Vyber proxy
Self-signed certificate file=Vlastnoručně podepsaný certifikát
Self-signed or user-provided certificate=Vlastnoručně nebo uživatelsky poskytnutý certifikát
Send crash information to Unraid developers=Odeslat informace o chybě vývojářům Unraidu
Send every hour=Odesílat každou hodinu
Send every two hours=Odesílat každé dvě hodiny
Send four times a day=Odesílat čtyřikrát denně
Send once a day=Odesílat jednou denně
Send once a month=Odesílat jednou měsíčně
Send once a week=Odesílat jednou týdně
Send three times a day=Odesílat třikrát denně
Send twice a day=Odesílat dvakrát denně
Sending email address=Odesílací e-mailová adresa
Server hub spoke access=Přístup serveru jako hub & spoke
Server name=Název serveru
Server to server access=Přístup server–server
Server was unable to provision SSL certificate=Server nemohl vystavit SSL certifikát
Set password=Nastavit heslo
Setting disabled in safe mode=Nastavení je v **nouzovém režimu** zakázáno
Settings menu=Nabídka nastavení
Show array utilization indicator=Zobrazit indikátor vytížení array
Show banner background color fade=Zobrazit přechod pozadí banneru
Show banner=Zobrazit banner
Show Dashboard apps=Zobrazit aplikace na Dashboardu
show passphrase=Zobrazit přístupovou frázi
Show Peer Config=Zobrazit konfiguraci peeru
Show RDP menu option=Zobrazit možnost RDP v menu
Show RDP option=Zobrazit možnost RDP
Show VM Usage=Zobrazit využití VM
Shutdown time-out=Časový limit pro vypnutí
Shutdown VMs=Vypnout VM
shutdown=Vypnutí
Sign In to Unraidnet required=Vyžaduje přihlášení k Unraid.net
Simple=Jednoduché
slave=Slave
Slow=Pomalé
Small=Malé
Smart=Chytré
SMB Extras=SMB rozšíření
SMB Settings=Nastavení SMB
SMB=SMB
SMTP Settings=Nastavení SMTP
SNMP=SNMP
Software=Software
Sorry, an error occurred in processing your SSL certificate=Omlouváme se, při zpracování SSL certifikátu došlo k chybě
Sorry, an error occurred updating unraidnet DNS records=Omlouváme se, při aktualizaci DNS záznamů unraid.net došlo k chybě
SSH port=SSH port
Start APC UPS daemon=Spustit APC UPS démon
Start page=Úvodní stránka
Static=Statické
Stop %s to make changes, see=Zastav **%s**, abys mohl provést změny, viz
Stop corresponding docker containers=Zastavit odpovídající Docker kontejnery
Store notifications to flash=Ukládat oznámení na flash disk
stripe=stripe
Subject=Předmět
Subnet=Podsíť
subnet=Podsíť
success=Úspěch
Summarized=Souhrn
Switching the Storage Driver requires to delete and rebuild the Docker directory manually=Změna úložištního ovladače vyžaduje ruční smazání a znovuvytvoření Docker adresáře!
Syslog Server=Syslog server
System goes down=Systém padá
System identifier for logfile name=Systémový identifikátor pro název logu
System notifications=Systémová oznámení
System Setting=Systémové nastavení
System Settings=Systémová nastavení
Tabbed=Na záložkách
Tailscale URLs=Tailscale odkazy
TCP=TCP
TELNET port=TELNET port
Temperature unit=Jednotka teploty
Template Authoring Mode=Režim tvorby šablony
Terminal font size=Velikost písma terminálu
Test running=Test probíhá
Test=Test
Text - Bar color=Text - Řádka (barva)
Text - Bar gray=Text - Řádka (šedá)
Text=Text
The Local endpoint does not resolve to an IPv4 address=Lokální koncový bod nelze přeložit na platnou IPv4 adresu
The Local endpoint does not resolve to an IPv6 address=Lokální koncový bod nelze přeložit na platnou IPv6 adresu
The Local endpoint resolves to=Lokální koncový bod přeložen na
The Local tunnel network pool cannot be in=Lokální síťový fond tunelu nesmí být v
The Local tunnel network pool IPv6 cannot be in=Lokální IPv6 síťový fond tunelu nesmí být v
Third week=Třetí týden
This is required to create VMs in KVM=Tohle je vyžadováno pro vytvoření VMs v KVM
this mode requires a network switch with proper setup and support=Tento režim vyžaduje správně nakonfigurovaný síťový přepínač s odpovídající podporou
this must be the only peer in the tunnel and sole active tunnel when in use=Musí jít o jediného partnera v tunelu a jediný aktivní tunel při používání
This removes any connections running over this tunnel=To odstraní všechna připojení běžící přes tento tunel
This Unraid Server was unreachable from the outside=Tento Unraid server nebyl zvenčí dostupný
This will unassign all devices from the pool but will NOT modify any device contents=Tím se zruší přiřazení všech zařízení z poolu, ale obsah zařízení zůstane beze změny
Time format=Formát času
Time of the day=Denní čas
Time on battery before shutdown=Doba na baterii před vypnutím
Time state=Časový stav
Time sync=Synchronizace času
Time zone=Časové pásmo
time-out=Časový limit
Timestamp=Časové razítko
TLS certificate location=Umístění TLS certifikátu
To test your manual port forward, temporarily configure Allow Remote Access as Always On - Manual Port Forward=Pro otestování manuálního přesměrování portu nastav „Povolit vzdálený přístup“ do režimu „Vždy zapnuto – ruční přesměrování portu“
to=do
Toggle keys=Přepnout klíče
Toggle thread to containers=Přepnout vlákno na kontejnery
Toggle view=Změnit zobrazení
top-left=levý horní roh
top-right=pravý horní roh
Trim Now=Spustit TRIM nyní
TRIM operation started=TRIM operace spuštěna
TRIM schedule=Harmonogram TRIMu
TRIM Settings=Nastavení TRIMu
trim=trim
Tunable enable Direct IO=Nastavit Direct I/O
Tunable enable NCQ=Nastavit NCQ
Tunable fuse_remember=Nastavit fuse_remember
Tunable md_num_stripes=Nastavit md_num_stripes
Tunable md_queue_limit=Nastavit md_queue_limit
Tunable md_sync_limit=Nastavit md_sync_limit
Tunable md_write_method=Nastavit md_write_method
Tunable nr_requests=Nastavit počet požadavků
Tunable poll_attributes=Nastavit sledování atributů
Tunable scheduler=Nastavit plánovač
Tunable support Hard Links=Podpora pevných odkazů (Hard Links)
Tunnel has running containers attached=Na tunel jsou připojeny běžící kontejnery
tunnel is inactive=tunel je neaktivní
Tunnel wg0=Tunel wg0
Turn off UPS after shutdown=Vypnout UPS po vypnutí
Type new passphrase=Zadej novou přístupovou frázi
UDP=UDP
UDPv4=UDPv4
UDPv6=UDPv6
Unable to register this Unraid Server=Nepodařilo se zaregistrovat tento Unraid server
Unassigned Devices=Nezařazená zařízení
unavailable=Nedostupné
Unicast=Unicast
Unlimited=Neomezeně
Unraid Connect=Unraid Connect
Unraid Lets Encrypt certificate=Unraid Let’s Encrypt certifikát
Unraid OS update notification=Oznámení o aktualizaci Unraid OS
Unraid OS update=Aktualizace Unraid OS
Unraidnet account status=Stav účtu Unraid.net
Unraidnet Status=Stav Unraid.net
Update DNS=Aktualizovat DNS
updating=aktualizuji
Updating=Aktualizace
Upgrade Cert=Upgradovat certifikát
Upgrade ZFS Pool=Upgradovat ZFS pool
UPnP forwarding not set=UPnP přesměrování není nastaveno
UPnP state changed to=Stav UPnP změněn na
UPnP tunnel is inactive=Tunel UPnP je neaktivní
Upon host shutdown=Při vypnutí hostitele
UPS cable=Kabel k UPS
UPS Details=Detaily UPS
UPS Load=Zátěž UPS
UPS Model=Model UPS
UPS overloaded=UPS přetížena
UPS Settings=Nastavení UPS
UPS Status=Stav UPS
UPS type=Typ UPS
URL=URL
USB=USB
Use DEFAULT setting when public NTP servers are defined=Použít výchozí nastavení při použití veřejných NTP serverů
Use image name dockerimg or docker-xfsimg or select a folder=Použij název image docker.img nebo docker-xfs.img, nebo vyber složku
Use NTP=Použít NTP
Use only letters A-Z, digits or space,dash,underscore=Použij pouze písmena A–Z, číslice, mezeru, pomlčku nebo podtržítko
use printable characters only=používej pouze tisknutelné znaky
Use SSH=Použít SSH
Use SSLTLS=Použít SSL/TLS
Use STARTTLS=Použít STARTTLS
Use TELNET=Použít TELNET
Use UPnP=Použít UPnP
Used Free columns=Sloupce Použito / Volné
User Preferences=Nastavení uživatele
User root=Uživatel root
User shares not enabled=Uživatelské sdílení není aktivní
User Utilities=Uživatelské nástroje
User=Uživatel
Username=Uživatelské jméno
user-set=uživatelské nastavení
uses=Používá
value must be a number=hodnota musí být číslo
Value=Hodnota
Very large=Velmi velké
Very small=Velmi malé
VFIO allow unsafe interrupts=VFIO: povolit nebezpečná přerušení
View libvirt log=Zobrazit log libvirt
View Local Config=Zobrazit lokální konfiguraci
View Peer Config=Zobrazit konfiguraci partnera
View the Docs for more information=Podívej se do dokumentace pro více informací
view=Zobrazit
Virt-Manager Remote Viewer=Virt-Manager Vzdálené zobrazení
VLAN assignment mismatch=Chybná přiřazení VLAN
VLAN number=Číslo VLAN
VM Manager=Správce VM
VM manager=Správce VM
VM Settings A reboot is required to apply changes=Nastavení VM: změny se projeví až po restartu
VM shutdown time-out=Časový limit pro vypnutí VM
VM Usage refresh timerseconds=Časovač obnovy údajů o využití VM (v sekundách)
VM=VM
VMs only=Pouze VM
VMs will be available after Array is Started=VM budou dostupné po spuštění pole
VPN Manager=Správce VPN
VPN tunnel access for System=VPN přístupový tunel pro systém
VPN tunnel for docker containers only=VPN tunel pouze pro Docker kontejnery
VPN tunneled access for docker=VPN přístup přes tunel pro Docker
VPN tunneled access for system=VPN přístup přes tunel pro systém
VPN tunneled access=VPN přístup přes tunel
WAN Port=WAN port
Warnings=Varování
Watts=Watt
Web interface=Webové rozhraní
Week of the month=Týden v měsíci
Weekly=Týdně
When running Unraid virtualized, there are no available power modes=Při běhu Unraidu ve virtualizovaném prostředí nejsou dostupné žádné režimy napájení
WireGuard Configuration=Konfigurace WireGuard
WireGuard URLs=WireGuard adresy
Workgroup Settings=Nastavení pracovní skupiny
Workgroup=Pracovní skupina
Write corrections to parity disk=Zapsat opravy na paritní disk
Wrong PTP server address=Chybná adresa PTP serveru
WSD options experimental=Experimentální možnosti WSD
xfs vDisk=xfs vDisk
Yearly=Ročně
You can not exclude this interface=Nelze vyloučit toto rozhraní
You must be signed in to Unraidnet in order to generate an Unraidnet SSL certificate=Pro vytvoření SSL certifikátu Unraid.net musíš být přihlášen k Unraid.net
Your existing Docker image file needs to be recreated due to an issue from an earlier beta of Unraid 6=Stávající Docker image je třeba znovu vytvořit kvůli problému z dřívější betaverze Unraid 6
Your hardware does not have Intel VT-x or AMD-V capability=Tvůj hardware nepodporuje Intel VT-x ani AMD-V
Your Lets Encrypt SSL Certificate has been provisioned and a DNS record for local IP address=SSL certifikát Let's Encrypt byl vystaven a DNS záznam pro lokální IP adresu byl vytvořen
Your Lets Encrypt SSL Certificate has been renewed=SSL certifikát Let's Encrypt byl obnoven
Your local IP address %s has been updated for unraidnet=Tvoje lokální IP adresa %s byla aktualizována pro unraid.net
Your router or DNS server has DNS rebinding protection enabled, preventing=Na tvém routeru nebo DNS serveru je aktivní ochrana proti DNS rebindingu, což brání
Your server has been registered=Tvůj server byl zaregistrován
Your Unraid Server is reachable from the internet=Tvůj Unraid server je dostupný z internetu
YYYY-MM-DD=RRRR-MM-DD
zfs pool information=Informace o ZFS poolu
zfs=ZFS

; My Servers plugin
Account status=Stav účtu
Also delete cloud backup Restore from backup will be unavailable=Také smazat zálohu v cloudu. Obnovení ze zálohy pak nebude možné.
Always - Manual Port Forward=Vždy - Manuální přesměrování portu
Always - UPnP=Vždy - UPnP
Are you sure you want pause communication with your remote flash backup on unraidnet=Opravdu chceš pozastavit komunikaci se vzdálenou flash zálohou na unraid.net?
Are you sure you want to delete your cloud backup Restore from backup will be unavailable=Opravdu chceš smazat svou cloudovou zálohu? Obnovení nebude nadále možné.
Are you sure you want to delete your local flash backup=Opravdu chceš smazat svou místní flash zálohu?
Are you sure you want to erase all change history in both local and unraidnet remote=Opravdu chceš vymazat celý záznam změn jak místní, tak i vzdálený na unraid.net?
Connected to My Servers Cloud=Připojeno ke cloudové službě My Servers
Delete Cloud Backup=Odstranit cloudovou zálohu
Disabled until connected to My Servers Cloud=Deaktivováno, dokud nebude připojeno k My Servers Cloud
Disabled until you have signed in=Deaktivováno, dokud se nepřihlásíš
Disabled until you Provision a myunraidnet SSL Cert=Deaktivováno, dokud nebude vystaven SSL certifikát *.myunraid.net
Disabled until you Provision an unraidnet SSL Cert and set SSL-TLS to Auto=Deaktivováno, dokud nebude vystaven SSL certifikát *.unraid.net a SSL/TLS nebude nastaveno na Auto
Disabled until you Provision an unraidnet SSL Cert=Deaktivováno, dokud nebude vystaven SSL certifikát *.unraid.net
Disabled until your root user account is password-protected=Deaktivováno, dokud účet „root“ není chráněn heslem
Dynamic - Manual Port Forward=Dynamicky - Manuální přesměrování portu
Dynamic - UPnP=Dynamicky - UPnP
Dynamic Remote Access allows you to do stuff that someone else can explain=Dynamický vzdálený přístup ti umožňuje dělat věci, které ti někdo jiný vysvětlí 😄
Enable Transparent 2FA for Local Access=Aktivovat transparentní 2FA pro místní přístup
Enable Transparent 2FA for Remote Access=Aktivovat transparentní 2FA pro vzdálený přístup
In order to activate Flash Backup there must be at least 1GB of free space on your flash drive=Pro aktivaci flash zálohy musí být na tvém flash disku alespoň 1 GB volného místa
Local T2FA requires a myunraidnet certificate=Místní T2FA vyžaduje certifikát *.myunraid.net
Local T2FA requires Unraid 610 or higher and a myunraidnet certificate=Místní T2FA vyžaduje Unraid 6.10 nebo novější a certifikát *.myunraid.net
Local T2FA requires Unraid 610 or higher=Místní T2FA vyžaduje Unraid 6.10 nebo novější
Local T2FA requires Use SSLTLS to be Auto and a myunraidnet certificate=Místní T2FA vyžaduje certifikát *.myunraid.net a nastavení SSL/TLS na „Auto“
Local T2FA requires Use SSLTLS to be Auto and Unraid 610 or higher=Místní T2FA vyžaduje Unraid 6.10 nebo vyšší a SSL/TLS nastaveno na „Auto“
Local T2FA requires Use SSLTLS to be Auto, Unraid 610 or higher, and a myunraidnet certificate=Místní T2FA vyžaduje Unraid 6.10 nebo vyšší, SSL/TLS na „Auto“ a certifikát *.myunraid.net
Local T2FA requires Use SSLTLS to be Auto=Pro místní T2FA musí být SSL/TLS nastaveno na „Auto“
More information=Více informací
port=Port
Remote T2FA requires a myunraidnet certificate=Vzdálené T2FA vyžaduje certifikát *.myunraid.net
Remote T2FA requires Remote Access to be enabled and a myunraidnet certificate=Vzdálené T2FA vyžaduje aktivní vzdálený přístup a certifikát *.myunraid.net
Remote T2FA requires Remote Access to be enabled and Unraid 610 or higher=Vzdálené T2FA vyžaduje aktivní vzdálený přístup a Unraid 6.10 nebo vyšší
Remote T2FA requires Remote Access to be enabled, Unraid 610 or higher, and a myunraidnet certificate=Vzdálené T2FA vyžaduje aktivní vzdálený přístup, Unraid 6.10 nebo vyšší a certifikát *.myunraid.net
Remote T2FA requires Remote Access to be enabled=Vzdálené T2FA vyžaduje aktivovaný vzdálený přístup
Remote T2FA requires Unraid 610 or higher and a myunraidnet certificate=Vzdálené T2FA vyžaduje Unraid 6.10 nebo vyšší a certifikát *.myunraid.net
Remote T2FA requires Unraid 610 or higher=Vzdálené T2FA vyžaduje Unraid 6.10 nebo vyšší
The Unraid server is unreachable from outside your network Be sure you have configured your router to forward port=Unraid server není dostupný z vnější sítě. Ujisti se, že máš na routeru nastaveno přesměrování portu
to the Unraid server at=na Unraid server na adrese
Transient errors in this log can be ignored unless you are having issues=Dočasné chyby v tomto logu lze ignorovat, pokud nedochází k problémům
Unraid API extra origins=Unraid API - další povolené zdroje
View Flash Backup Error Log=Zobrazit chybový protokol Flash zálohy
