Add Share=Přidat sdílení
All files encrypted=Všechny soubory zašifrovány
All files protected=Všechny soubory chráněny
All files unprotected=Všechny soubory nechráněny
Allocation method=Metoda alokace
Array must be Started to view Shares=Pro zobrazení sdílení musí být pole **spuštěné**
Automatically split any directory as required=Automaticky rozdělit složky podle potřeby
Automatically split only the top five directory levels as required=Automaticky rozdělit podle potřeby pouze vrchních pět úrovní složek
Automatically split only the top four directory levels as required=Automaticky rozdělit podle potřeby pouze vrchní čtyři úrovně složek
Automatically split only the top level directory as required=Automaticky rozdělit podle potřeby pouze vrchní úroveň složek
Automatically split only the top three directory levels as required=Automaticky rozdělit podle potřeby pouze vrchní tři úrovně složek
Automatically split only the top two directory levels as required=Automaticky rozdělit podle potřeby pouze vrchní dvě úrovně složek
Clean Up=Vyčištění
CLEAN UP=VYČIŠTĚNÍ
Comments=Komentáře
Compute All=Vypočítat vše
Compute=Vypočítat
Disk Shares=Diskové sdílení
Do not use pool names=Nepoužívat názvy poolů
Do not use reserved names=Nepoužívat rezervovaná jména
Enable Copy-on-write=Povolit Copy-on-write
Enter a name for the share=Zadejte název sdílení
Excluded disks=Vyloučené disky
Excluded disk(s)=Vyloučený disk(y)
Exclusive access=Výhradní přístup
Export=Exportovat
Fill-up=Zaplnit
Free Space will be calculated=Volné místo bude spočítáno
Free=Volné
has been deleted=byl odstraněn
HDD=HDD
High-water=High-water (metoda vyvažování)
Included disks=Zařazené disky
Included disk(s)=Zařazený disk(y)
Invalid Characters=Neplatné znaky
Invalid share name=Neplatný název sdílení
is missing=chybí
it references storage that does not exist=odkazuje na neexistující úložiště
It references storage that does not exist=Odkazuje na neexistující úložiště
Manual do not automatically split directories=Manuální: nerozdělovat složky automaticky
Minimum free space=Minimální volné místo
Missing share name=Chybějící název sdílení
Most-free=Nejvíce volného
Mover action=Akce přesouvacího procesu (Mover)
Mover takes no action=Mover neprovádí žádnou akci
Mover transfers files from array to cache=Mover přesouvá soubory z pole na cache
Mover transfers files from cache to array=Mover přesouvá soubory z cache na pole
Mover transfers files from Primary storage to Secondary storage=Mover přesouvá soubory z primárního do sekundárního úložiště
Mover transfers files from Secondary storage to Primary storage=Mover přesouvá soubory ze sekundárního do primárního úložiště
next user share=další uživatelské sdílení
No unused share configurations present=Nejsou žádné nepoužité konfigurace sdílení
Not used=Nepoužito
Only=Pouze
Prefer=Přednost
previous user share=předchozí uživatelské sdílení
Primary storage %s=Primární úložiště %s
Primary storage for new files and folders=Primární úložiště (pro nové soubory a složky)
Primary storage to Secondary storage=Primární do sekundárního úložiště
Read=Čtení
Recompute=Znovu vypočítat
Remove unused share configurations=Odstranit nepoužité konfigurace sdílení
Removed share configurations=Odstraněné konfigurace sdílení
Rule=Pravidlo
Secondary storage to Primary storage=Sekundární do primárního úložiště
Secondary storage=Sekundární úložiště
Select cache pool=Vybrat cache pool
Set when adding new share only=Nastavit pouze při přidání nového sdílení
Share contains data=Sdílení obsahuje data
Share is empty and is safe to delete=Sdílení je prázdné a lze jej bezpečně odstranit
Share is empty=Sdílení je prázdné
Share is outside the list of designated disks=Sdílení je mimo seznam určených disků
Share must be empty to be deleted=Sdílení musí být prázdné, aby mohlo být odstraněno
Share name contains invalid characters for ZFS use=Název sdílení obsahuje neplatné znaky pro ZFS
Share Settings=Nastavení sdílení
Share status=Stav sdílení
Size=Velikost
Some or all files unencrypted=Některé nebo všechny soubory nejsou zašifrovány
Some or all files unprotected=Některé nebo všechny soubory nejsou chráněny
Split level=Úroveň dělení
SSD=SSD
Storage=Úložiště
There are no exportable disk shares=Nejsou žádná exportovatelná disková sdílení
There are no exportable user shares=Nejsou žádná exportovatelná uživatelská sdílení
There are no mountable array or pool disks - cannot add shares=Nejsou žádné připojitelné disky pole nebo poolu - nelze přidat sdílení
There are no mounted array or pool disks - cannot add shares=Nejsou žádné připojené disky pole nebo poolu - nelze přidat sdílení
This share is invalid=Toto sdílení je neplatné
Time Machine volume size limit=Limit velikosti Time Machine svazku
Unknown cache usage=Neznámé využití cache
Unknown encryption state=Neznámý stav šifrování
Unknown protection status=Neznámý stav ochrany
Use cache pool for new filesdirectories=Použít cache pool (pro nové soubory/složky)
User Shares=Uživatelská sdílení
Warning: Configured Pool=Upozornění: nastavený pool
Write=Zápis
You cannot use the following within share names=Není možné použít následující znaky v názvech sdílení
