20 EHCI=2.0 (EHCI)
30 nec XHCI=3.0 (nec XHCI)
30 qemu XHCI=3.0 (qemu XHCI)
9p Mode=Režim 9p
Advanced tuning options=Pokročilé možnosti ladění
Allocation=Přiřazení
and if using graphics device passthrough it too needs UEFI=a pokud používáte přímý přístup k grafickému zařízení, i ono vyžaduje UEFI
Are you sure=Jste si jisti?
Array must be started to view Virtual Machines=Pole musí být **spuštěno**, abyste mohli zobrazit virtuální stroje
Autostart=Automatické spuštění
Back=Zpět
Base Image=Základní obraz
Block Devices=Bloková zařízení
Boot Order=Pořadí bootování
Boot order=Pořadí bootování
Bus=Sběrnice
Capacity=Kapacita
CD1 ISO Image=ISO obraz CD1
CD2 ISO Image=ISO obraz CD2
Change Icon=Změnit ikonu
Check free space=Zkontrolovat volné místo
Cleanup=Vyčištění
Click and Select cdrom image to install operating system=Klikněte a vyberte obraz CD-ROM pro instalaci operačního systému
Clock Offset=Posun hodin
Clocks Offset=Posun hodin
Clocks=Hodiny
Clone=Klonovat
Config Folder=Konfigurační složka
Configure the same IP address on the ipvtap interface=Nastavte stejnou IP adresu na rozhraní ipvtap
Configure the VM with a static IP address=Nakonfigurujte VM se statickou IP adresou
Copy Paste Domain XML Configuration Here=Zkopírujte a vložte XML konfiguraci domény sem
CPU Mode=Režim CPU
CPUs=CPU (procesory)
Create=Vytvořit
CreateModify Template=Vytvořit/Upravit šablonu
Creating=Vytváření
DateTime=Datum/Čas
define if migratable=určete, zda je možné migraci
define Multifunctiion Support=určete podporu více funkcí
define OS boot options=určete možnosti spuštění OS
define the amount memory=určete množství paměti
define the maximum amount of memory=určete maximální množství paměti
define type of cpu presented to this vm=určete typ CPU prezentovaného tomuto VM
description of virtual machine=popis virtuálního stroje
Description=Popis
Deselect All=Odznačit vše
Discard=Zahodit
Disk capacity has to be greater than %s=Kapacita disku musí být větší než %s
Disk devices=Disková zařízení
Disk devicesVolume=Disková zařízení/Svazek
Disk IO=Diskové I/O
Displays and RAM=Displeje a RAM
Download Folder=Složka pro stažení
Download, Click and Select virtio drivers image=Stáhněte, klikněte a vyberte obraz ovladačů virtio
Downloading=Stahování
Driver=Ovladač
Edit VM after clone=Upravit VM po klonování
eg=npr. (např.)
Eject CD Drive=Vysunout CD mechaniku
Emulated=Emulované
Enable USB boot=Povolit bootování z USB
Enter name=Zadejte název
Error occured=Došlo k chybě
ETA=Odhadovaný čas dokončení (ETA)
Evdev Device=Zařízení Evdev
Export User Template=Exportovat uživatelskou šablonu
Extracting=Rozbalování
File exists=Soubor již existuje
File for import=Soubor pro import
File write failed=Zápis souboru selhal
Files being removed=Odstraňují se soubory
Folder to save the LibreELEC image to=Složka pro uložení obrazu LibreELEC
Folder to save the OpenELEC image to=Složka pro uložení obrazu OpenELEC
Form View=Zobrazení formuláře
free=volné
FS Native Snapshot=Nativní snapshot FS
GPU is primary adapter, vbios may be required=GPU je primární adaptér, může být potřeba VBIOS
grab options=možnosti převzetí (grab)
Grab Toggle=Zapnout/vypnout převzetí
Grab=Převzít
Graphics Card=Grafická karta
Graphics ROM BIOS=Grafický ROM BIOS
Graphics ROM Needed=Vyžadován grafický ROM
Graphics=Grafika
Guest agent not installed=Guest agent není nainstalován
Guest CPU=CPU hostovaného systému
Guest not running or guest agent not installed=Hostující systém neběží nebo agent není nainstalován
Guest not running=Hostující systém neběží
Hide inline xml=Skrýt vložené XML
Host CPU=CPU hostitelského systému
Host Passthrough=Host Passthrough (přímý přístup k CPU)
Hyperv tweaks for Windows=Hyper-V úpravy pro Windows
Hyper-V=Hyper-V
i440fx will work for most=i440fx bude fungovat pro většinu případů
Icon=Ikona
If name already exists it will be replaced=Pokud název již existuje, bude nahrazen
Import from file=Import ze souboru
Import=Importovat
Initial=Počáteční
Insert CD=Vložit CD
Insert=Vložit
Interfaces=Rozhraní
Invalid storage path=Neplatná cesta k úložišti
Invalid VM to edit=Neplatný VM pro úpravu
IP Address=IP adresa
ISO Image=ISO obraz
ISO storage path doesnt exist, please create the user share or empty folder first=Cesta k ISO úložišti neexistuje, nejprve vytvořte sdílenou složku nebo prázdnou složku
ISO storage path doesnt exist=Cesta k ISO úložišti neexistuje
ISO storage path was empty=Cesta k ISO úložišti byla prázdná
keyboard for VM Console=Klávesnice pro VM konzoli
keyboard for VNC=Klávesnice pro VNC
Leaving blank will use OS name=Pokud ponecháte prázdné, použije se název OS
LibreELEC Version=Verze LibreELEC
LibreELEC=LibreELEC
Libvirt Service failed to start=Službu Libvirt se nepodařilo spustit
Location of virtual machine files=Umístění souborů virtuálního stroje
Lock sortable items=Zamknout položky pro třídění
Logical CPUs=Logické CPU
Machine=Stroj
Manual configuration required=Je vyžadována ruční konfigurace
Manual Configuration Required=Je vyžadována ruční konfigurace
Manual=Manuálně
Max=Max
MD5 verification failed, your download is incomplete or corrupted=MD5 kontrolní součet selhal, stahování je neúplné nebo poškozené
Memory dump=Výpis paměti
Memory inuseCurrentMaximum=Paměť využitá/Aktuální/Maximální
Migratable=Migrovatelné
Mode=Režim
mount tag inside vm=značka připojení uvnitř VM
Multifunction=Více funkcí
My Workstation=Moje pracovní stanice
Name contains invalid characters or does not start with an alphanumberic for a ZFS storage location=Název obsahuje neplatné znaky nebo nezačíná alfanumerickým znakem pro ZFS umístění
Name contains invalid characters or does not start with an alphanumberic for a ZFS storage locationOnly these special characters are valid Underscore _ Hyphen - Colon Period =Název obsahuje neplatné znaky nebo nezačíná alfanumerickým znakem pro ZFS úložiště<br>Povolené speciální znaky: podtržítko (_), pomlčka (-), dvojtečka (:), tečka (.)
name of mount tag inside vm=název připojovací značky uvnitř VM
Name of virtual machine=Název virtuálního stroje
Network Bridge=Síťový most (bridge)
Network IO=Síťové I/O
Network MAC=MAC adresa sítě
Network Model=Model síťového adaptéru
Network Source=Zdroj sítě
New VM=Nový VM
No CD image inserted in to drive=V mechanice není vložen žádný obraz CD
No CD image inserted into drive=V mechanice není vložen žádný obraz CD
No GPU=Žádná GPU
No IP, guest agent not installed=Žádná IP adresa, guest agent není nainstalován
No pinning set=Není nastaveno žádné připnutí
No Virtual Machines installed=Není nainstalován žádný virtuální stroj
nogpu=bez GPU
None available=Není k dispozici
Not enough free space, need at least %s MB=Nedostatek volného místa, je potřeba alespoň %s MB
Not running=Neaktivní
Not set=Nenastaveno
Only one VM can be active at the time=Současně může být aktivní pouze jeden VM
Only these special characters are valid Underscore _ Hyphen - Colon Period=Jsou povoleny pouze tyto speciální znaky: podtržítko (_), pomlčka (-), dvojtečka (:), tečka (.)
OpenELEC Version=Verze OpenELEC
OpenELEC=OpenELEC
Optional=Volitelné
OS Install CDRom Bus=Sběrnice CD-ROM pro instalaci OS
OS Install ISO=ISO obraz pro instalaci OS
Other PCI Devices=Další PCI zařízení
Other XML=Ostatní XML
Override Storage Location=Přepsat umístění úložiště
Overwrite=Přepsat
OVMF requires a UEFI-compatable OS=OVMF vyžaduje operační systém kompatibilní s UEFI
OVMF TPM=OVMF TPM
OVMF=OVMF
Parent=Nadřazený
password for VM Console=Heslo pro VM konzoli
password for VNC=Heslo pro VNC
path of Unraid share=Cesta ke sdílené složce v Unraid
path on Unraid share to save LibreELEC settings=Cesta na sdílené složce v Unraid pro uložení nastavení LibreELEC
path on Unraid share to save OpenELEC settings=Cesta na sdílené složce v Unraid pro uložení nastavení OpenELEC
Path to ROM BIOS file=Cesta k souboru ROM BIOS
Pinned Cores=Připnutá jádra
Pivot=Osa otáčení
Please choose a folder the LibreELEC image will download to=Vyberte složku, do které se stáhne obraz LibreELEC
Please choose a folder the OpenELEC image will download to=Vyberte složku, do které se stáhne obraz OpenELEC
Pop-up Blocker is enabled Please add this site to your exception list=Blokování vyskakovacích oken je povoleno! Přidejte tuto stránku do seznamu výjimek
port for virtual console=Port pro virtuální konzoli
Prefix=Prefix
Present=Přítomný
Primary=Primární
protocol for virtual console=Protokol pro virtuální konzoli
Q35 for a newer machine model with PCIE=Q35 pro novější model stroje s PCIE
QEMU Command Line=Příkazový řádek QEMU
QEMU64=QEMU64
random mac, you can supply your own=Náhodná MAC adresa, můžete zadat vlastní
re-generate random mac address=Znovu vygenerovat náhodnou MAC adresu
Remove all files=Odstranit všechny soubory
Remove Images=Odstranit obrazy
Remove LibreELEC image=Odstranit obraz LibreELEC
Remove Meta=Odstranit metadata
Remove OpenELEC image=Odstranit obraz OpenELEC
Remove this LibreELEC file=Odstranit tento soubor LibreELEC
Remove this OpenELEC file=Odstranit tento soubor OpenELEC
Remove User Template=Odstranit uživatelskou šablonu
Rename disabled, %s snapshots exists=Přejmenování zakázáno, existuje %s snímek(ů)
Render GPU=Vykreslovací GPU
RenderGPU=Vykreslovací GPU
Repeat=Opakovat
Requires guest agent installed=Vyžaduje nainstalovaný guest agent
Requires guest running=Vyžaduje spuštěný guest
Save File Name=Uložit název souboru
Save Path=Cesta pro uložení
SeaBIOS will work for most=SeaBIOS bude fungovat pro většinu případů
SeaBIOS=SeaBIOS
Select All=Vybrat vše
Select File=Vybrat soubor
Select ISO image=Vybrat ISO obraz
Select ISO=Vybrat ISO
Select ISOs for CDROMs=Vybrat ISO obrazy pro CD mechaniky
Select the BIOS=Vyberte BIOS
Select the LibreELEC version to use=Vyberte verzi LibreELEC, kterou chcete použít
Select the machine model=Vyberte model stroje
Select the OpenELEC version to use=Vyberte verzi OpenELEC, kterou chcete použít
Select the USB Controller to emulate=Vyberte USB řadič k emulaci
Select=Vybrat
Separate sub-folder and image will be created based on Name=Na základě názvu bude vytvořena samostatná podsložka a obraz
Serial=Seriové číslo
Set discard option=Nastavit volbu „discard“
Set SDD flag=Nastavit příznak SDD
Set SSD flag=Nastavit příznak SSD
shares=sdílené složky
Show Inline XML=Zobrazit vložené XML
Snapshot Method=Metoda snímku
Snapshot Name=Název snímku
Snapshot=Snímek
Snapshots being removed=Snímky se odstraňují
Snapshots=Snímky
Some OSes wont support USB3=Některé operační systémy nepodporují USB3
Sound Card=Zvuková karta
Specify a ISO storage path first=Nejprve zadejte cestu k úložišti ISO
SSD=SSD
Start All=Spustit vše
Start Cloned VM=Spustit klonovaný VM
Start VM after creation=Spustit VM po vytvoření
Stop All=Zastavit vše
Template exists=Šablona již existuje
Template file write failed=Chyba při zápisu souboru šablony
Template Name=Název šablony
Tickpolicy=Politika ticků
Timer Source=Zdroj časovače
Toggle VM autostart=Přepnout automatické spuštění VM
Top Image=Horní obraz
Type Method=Typ (metoda)
type of storage image=typ úložného obrazu
Unchecked will use QEMU External Snapshot=Bez zaškrtnutí se použije externí snímek QEMU
Unknown action=Neznámá akce
Unknown version=Neznámá verze
Unlock sortable items=Odemknout položky k řazení
Unraid Mount tag=Unraid přípojný tag
Unraid Mount Tag=Unraid přípojný tag
Unraid Share Mode=Režim sdílení Unraid
Unraid Share=Sdílení Unraid
Unraid Source Path=Cesta ke zdroji na Unraid
Updating=Aktualizuji
USB Controller=USB řadič
USB Devices=USB zařízení
vCPUs=Virtuální CPU
vDisk Bus=Větev vDisk
vDisk Location=Umístění vDisku
vDisk Size=Velikost vDisku
vDisk Type=Typ vDisku
vDisks vCDs=vDisky / vCD
vDisks=vDisky
Verifying=Ověřování
video for VM Console=Video pro konzoli VM
video for VNC=Video pro VNC
VirtIO Drivers CDRom Bus=CD-ROM větev pro VirtIO ovladače
VirtIO Drivers ISO=ISO s VirtIO ovladači
Virtiofs Mode=Režim Virtiofs
Virtual Machines=Virtuální stroje
Virtual=Virtuální
virtual=virtuální
VM Being Cloned=VM se klonuje
VM Being removed=VM se odstraňuje
VM Clone=Klon VM
VM Console AutoPort=Automatický port konzole VM
VM Console enable Copypaste=Konzole VM – povolit kopírování/vkládání
VM Console Keyboard=Klávesnice konzole VM
VM Console Password=Heslo ke konzoli VM
VM Console Port=Port konzole VM
VM Console Protocol=Protokol konzole VM
VM Console Video Driver=Ovladač videa pro konzoli VM
VM Console WS Port=WebSocket port konzole VM
VM creation error=Chyba při vytváření VM
VM image deletion error=Chyba při mazání obrazu VM
VM Name=Název VM
VM Usage Statisics=Statistiky využití VM
VM Usage Statistics=Statistiky využití VM
VNC Keyboard=Klávesnice VNC
VNC Password=Heslo VNC
VNC Video Driver=Video ovladač VNC
VNC=VNC
Warning removing Snapshots can break the chain=Upozornění: odstranění snímků může přerušit řetězec
Wasnt able to stop the process=Nepodařilo se zastavit proces
Web UI to start from menu=Webové rozhraní spustitelné z nabídky
Web UI to start=Spustit webové rozhraní
WebUI=Webové rozhraní
Windows 7XP=Windows 7/XP
Windows 82012, newer Linux distros=Windows 8/2012, novější distribuce Linuxu
wsport for virtual console=wsport pro virtuální konzoli
XML View=Zobrazení XML
